#.###.##
#.....##
###.#.##
###....#
#####S##