#.###.##
#.....##
###.#.##
###....#
#####.##