########.########
######.....######
######.#.#.######
######.#.#.######
####.........####
####.###.###.####
#....###.###....#
#.##.###.###.##.#
#.##.........##.#
#.##.###.###.##.#
#....###.###....#
####.###.###.####
####.........####
######.#.#.######
######.#.#.######
######.....######
########.########