########.########
######.....######
######.#.#.######
######.#.#.######
####.........####
####.#.#.###.####
#....###.##.....#
#.##.###.###.##.#
#.##.........##.#
#.##.###.###.##.#
#.....##.###....#
####.###.#.#.####
####.........####
######.#.#.######
######.#.#.######
######.....######
########.########